ixx0x0x0x0x0x0x000000x0x0x00
0000000000000000xxxx0x000000
x0x0x0x0x0x0xxxx000x00xxxxx0
0x0x0x0x0x0x00000x0x0x000000
00000000000x0x0xx0x00x0x0xx0
0xx0xxxxx0x00x0x000x0x00x0x0
000xx000x00x0x0x0x0x00x0x000
xx0000x0x0x00x0x0x00x0x0x0x0
00x0xx00x0x0x00x0x0x00x0x0x0
x00x0x0x00x0x0xx0x00x0x0x00x
0x000x0xx0x0x0000x0xx0x0xx00
00x0xx00x0x00xxxxx0000x000x0
x000x00x00x0x00000xxxxx0x0x0
00x00x00x0x0xx0xx000000x00x0
xx0x0x0x00x00x0x0xx0xx0x0x0x
00000x00x00x0x0x0x0x0x0x0000
0xxx0x0x0x000x0x00000x0x0xx0
0x000x0x00xxx00x0xxx0x0x0x00
0x0xx00x0x0000x0000x0x0x00x0
0x000x0x000xxx0xxxx00x00x0x0
00xx0x0x0xx000000000x00x00x0
0x000x0x0x0x0xxxxxxxx0x0x0x0
0xxx0x0x0x000000000000000xx0
0000x00x0xxxxxxxxxxxxxxx0000
xxx00x0x0000000000000000xxxx
0000x00x0x0x0x0x0x0x0xx00000
0xxx0x0xx0x0x0x0x0x0xx0xxxx0
000000000000000000000000000g
